----#####----------
----#---#----------
----#$--#----------
--###--$##---------
--#--$-$-#---------
###-#-##-#---######
#---#-##-#####--..#
#-$--$----------..#
#####-###-#@##--..#
----#-----#########
----#######--------

####
#--#
#-$#
#-.@
####
