{
  "levels": [
	{
	  "id": 1,
	  "name": "第一关：初识推箱",
	  "cols": 5,
	  "rows": 4,
	  "step_limit": 6,
	  "grid": [
		[1, 1, 1, 1, 1],
		[1, 3, 0, 0, 1],
		[1, 0, 2, 0, 1],
		[1, 1, 1, 1, 1]
	  ],
	  "targets": [[3, 2]]
	},
	{
	  "id": 2,
	  "name": "第二关：U 形弯",
	  "cols": 6,
	  "rows": 5,
	  "step_limit": 8,
	  "grid": [
		[1, 1, 1, 1, 1, 1],
		[1, 3, 0, 0, 0, 1],
		[1, 0, 2, 0, 0, 1],
		[1, 0, 0, 0, 0, 1],
		[1, 1, 1, 1, 1, 1]
	  ],
	  "targets": [[3, 1]]
	},
	{
	  "id": 3,
	  "name": "第三关：双箱协作",
	  "cols": 6,
	  "rows": 6,
	  "step_limit": 20,
	  "grid": [
		[1, 1, 1, 1, 1, 1],
		[1, 3, 0, 0, 0, 1],
		[1, 0, 2, 0, 0, 1],
		[1, 0, 0, 2, 0, 1],
		[1, 0, 0, 0, 0, 1],
		[1, 1, 1, 1, 1, 1]
	  ],
	  "targets": [[2, 1], [4, 3]]
	},
	{
	  "id": 4,
	  "name": "第四关：转角遇到箱",
	  "cols": 7,
	  "rows": 5,
	  "step_limit": 11,
	  "grid": [
		[1, 1, 1, 1, 1, 1, 1],
		[1, 3, 0, 0, 0, 0, 1],
		[1, 0, 2, 0, 0, 0, 1],
		[1, 0, 0, 0, 0, 0, 1],
		[1, 1, 1, 1, 1, 1, 1]
	  ],
	  "targets": [[4, 2]]
	},
	{
	  "id": 5,
	  "name": "第五关：一推到底",
	  "cols": 8,
	  "rows": 5,
	  "step_limit": 17,
	  "grid": [
		[1, 1, 1, 1, 1, 1, 1, 1],
		[1, 3, 0, 0, 0, 0, 0, 1],
		[1, 0, 0, 2, 0, 0, 0, 1],
		[1, 0, 0, 0, 0, 0, 0, 1],
		[1, 1, 1, 1, 1, 1, 1, 1]
	  ],
	  "targets": [[6, 2]]
	},
	{
	  "id": 6,
	  "name": "第六关：双箱上推",
	  "cols": 7,
	  "rows": 7,
	  "step_limit": 35,
	  "grid": [
		[1, 1, 1, 1, 1, 1, 1],
		[1, 1, 0, 0, 0, 1, 1],
		[1, 0, 0, 2, 0, 0, 1],
		[1, 3, 0, 0, 0, 0, 1],
		[1, 0, 0, 2, 0, 0, 1],
		[1, 1, 0, 0, 0, 1, 1],
		[1, 1, 1, 1, 1, 1, 1]
	  ],
	  "targets": [[2, 2], [4, 2]]
	},
	{
	  "id": 7,
	  "name": "第七关：向右看齐",
	  "cols": 8,
	  "rows": 6,
	  "step_limit": 20,
	  "grid": [
		[1, 1, 1, 1, 1, 1, 1, 1],
		[1, 1, 0, 0, 0, 0, 1, 1],
		[1, 0, 0, 2, 0, 0, 0, 1],
		[1, 3, 0, 0, 0, 2, 0, 1],
		[1, 1, 0, 0, 0, 0, 1, 1],
		[1, 1, 1, 1, 1, 1, 1, 1]
	  ],
	  "targets": [[4, 2], [6, 3]]
	},
	{
	  "id": 8,
	  "name": "第八关：T形路",
	  "cols": 8,
	  "rows": 7,
	  "step_limit": 20,
	  "grid": [
		[1, 1, 1, 1, 1, 1, 1, 1],
		[1, 3, 0, 0, 0, 0, 0, 1],
		[1, 0, 2, 0, 0, 0, 0, 1],
		[1, 0, 0, 0, 0, 0, 0, 1],
		[1, 0, 0, 0, 2, 0, 0, 1],
		[1, 0, 0, 0, 0, 0, 0, 1],
		[1, 1, 1, 1, 1, 1, 1, 1]
	  ],
	  "targets": [[2, 3], [5, 4]]
	},
	{
	  "id": 9,
	  "name": "第九关：迂回",
	  "cols": 9,
	  "rows": 7,
	  "step_limit": 32,
	  "grid": [
		[1, 1, 1, 1, 1, 1, 1, 1, 1],
		[1, 3, 0, 0, 0, 0, 0, 0, 1],
		[1, 0, 0, 2, 0, 0, 0, 0, 1],
		[1, 0, 0, 0, 0, 0, 0, 0, 1],
		[1, 0, 0, 0, 2, 0, 0, 0, 1],
		[1, 0, 0, 0, 0, 0, 0, 0, 1],
		[1, 1, 1, 1, 1, 1, 1, 1, 1]
	  ],
	  "targets": [[2, 2], [7, 4]]
	},
	{
	  "id": 10,
	  "name": "第十关：三角阵",
	  "cols": 9,
	  "rows": 8,
	  "step_limit": 44,
	  "grid": [
		[1, 1, 1, 1, 1, 1, 1, 1, 1],
		[1, 1, 0, 0, 0, 0, 0, 1, 1],
		[1, 0, 0, 2, 0, 0, 0, 0, 1],
		[1, 3, 0, 0, 0, 0, 0, 0, 1],
		[1, 0, 0, 0, 2, 0, 0, 0, 1],
		[1, 0, 0, 0, 0, 0, 2, 0, 1],
		[1, 1, 0, 0, 0, 0, 0, 1, 1],
		[1, 1, 1, 1, 1, 1, 1, 1, 1]
	  ],
	  "targets": [[4, 2], [6, 3], [3, 5]]
	},
	{
	  "id": 11,
	  "name": "第十一关：通道",
	  "cols": 8,
	  "rows": 7,
	  "step_limit": 23,
	  "grid": [
		[1, 1, 1, 1, 1, 1, 1, 1],
		[1, 3, 0, 0, 0, 0, 0, 1],
		[1, 0, 0, 2, 0, 0, 0, 1],
		[1, 0, 0, 0, 0, 0, 0, 1],
		[1, 0, 0, 2, 0, 0, 0, 1],
		[1, 0, 0, 0, 0, 0, 0, 1],
		[1, 1, 1, 1, 1, 1, 1, 1]
	  ],
	  "targets": [[3, 2], [2, 4]]
	},
	{
	  "id": 12,
	  "name": "第十二关：三足鼎立",
	  "cols": 9,
	  "rows": 8,
	  "step_limit": 41,
	  "grid": [
		[1, 1, 1, 1, 1, 1, 1, 1, 1],
		[1, 3, 0, 0, 0, 0, 0, 0, 1],
		[1, 0, 2, 0, 0, 0, 0, 0, 1],
		[1, 0, 0, 0, 0, 0, 0, 0, 1],
		[1, 0, 0, 0, 2, 0, 0, 0, 1],
		[1, 0, 0, 0, 0, 0, 0, 0, 1],
		[1, 0, 0, 0, 0, 0, 2, 0, 1],
		[1, 1, 1, 1, 1, 1, 1, 1, 1]
	  ],
	  "targets": [[3, 2], [6, 4], [4, 6]]
	},
	{
	  "id": 13,
	  "name": "第十三关：竞技场",
	  "cols": 9,
	  "rows": 9,
	  "step_limit": 29,
	  "grid": [
		[1, 1, 1, 1, 1, 1, 1, 1, 1],
		[1, 0, 0, 0, 0, 0, 0, 0, 1],
		[1, 0, 0, 2, 0, 0, 0, 0, 1],
		[1, 0, 0, 0, 0, 0, 0, 0, 1],
		[1, 0, 3, 0, 0, 0, 0, 0, 1],
		[1, 0, 0, 0, 0, 0, 2, 0, 1],
		[1, 0, 0, 0, 0, 0, 0, 0, 1],
		[1, 0, 0, 0, 0, 2, 0, 0, 1],
		[1, 1, 1, 1, 1, 1, 1, 1, 1]
	  ],
	  "targets": [[4, 2], [7, 5], [5, 7]]
	},
	{
	  "id": 14,
	  "name": "第十四关：多段推进",
	  "cols": 9,
	  "rows": 9,
	  "step_limit": 35,
	  "grid": [
		[1, 1, 1, 1, 1, 1, 1, 1, 1],
		[1, 3, 0, 0, 0, 0, 0, 0, 1],
		[1, 0, 2, 0, 0, 0, 0, 0, 1],
		[1, 0, 0, 0, 0, 0, 0, 0, 1],
		[1, 0, 0, 0, 2, 0, 0, 0, 1],
		[1, 0, 0, 0, 0, 0, 0, 0, 1],
		[1, 0, 0, 0, 0, 0, 2, 0, 1],
		[1, 0, 0, 0, 0, 0, 0, 0, 1],
		[1, 1, 1, 1, 1, 1, 1, 1, 1]
	  ],
	  "targets": [[3, 3], [5, 5], [6, 6]]
	},
	{
	  "id": 15,
	  "name": "第十五关：四箱入门",
	  "cols": 9,
	  "rows": 9,
	  "step_limit": 26,
	  "grid": [
		[1, 1, 1, 1, 1, 1, 1, 1, 1],
		[1, 3, 0, 0, 0, 0, 0, 0, 1],
		[1, 0, 2, 0, 0, 0, 0, 0, 1],
		[1, 0, 0, 0, 0, 0, 0, 0, 1],
		[1, 0, 0, 0, 2, 0, 0, 0, 1],
		[1, 0, 0, 0, 0, 0, 0, 0, 1],
		[1, 0, 0, 0, 0, 0, 2, 0, 1],
		[1, 0, 0, 0, 0, 0, 0, 2, 1],
		[1, 1, 1, 1, 1, 1, 1, 1, 1]
	  ],
	  "targets": [[4, 2], [3, 4], [6, 6], [7, 7]]
	},
	{
	  "id": 16,
	  "name": "第十六关：算力激增",
	  "cols": 10,
	  "rows": 8,
	  "step_limit": 44,
	  "grid": [
		[1, 1, 1, 1, 1, 1, 1, 1, 1, 1],
		[1, 3, 0, 0, 0, 0, 0, 0, 0, 1],
		[1, 0, 0, 2, 0, 0, 0, 0, 0, 1],
		[1, 0, 0, 0, 0, 0, 0, 0, 0, 1],
		[1, 0, 0, 0, 0, 2, 0, 0, 0, 1],
		[1, 0, 0, 0, 0, 0, 0, 0, 0, 1],
		[1, 0, 0, 0, 0, 0, 2, 0, 0, 1],
		[1, 1, 1, 1, 1, 1, 1, 1, 1, 1]
	  ],
	  "targets": [[4, 2], [7, 4], [3, 6]]
	},
	{
	  "id": 17,
	  "name": "第十七关：四面出击",
	  "cols": 10,
	  "rows": 9,
	  "step_limit": 23,
	  "grid": [
		[1, 1, 1, 1, 1, 1, 1, 1, 1, 1],
		[1, 3, 0, 0, 0, 0, 0, 0, 0, 1],
		[1, 0, 0, 2, 0, 0, 0, 0, 0, 1],
		[1, 0, 0, 0, 0, 0, 0, 0, 0, 1],
		[1, 0, 0, 0, 0, 2, 0, 0, 0, 1],
		[1, 0, 0, 0, 0, 0, 0, 0, 0, 1],
		[1, 0, 0, 0, 0, 0, 0, 2, 0, 1],
		[1, 0, 0, 0, 0, 0, 0, 0, 2, 1],
		[1, 1, 1, 1, 1, 1, 1, 1, 1, 1]
	  ],
	  "targets": [[4, 2], [6, 4], [7, 6], [8, 7]]
	},
	{
	  "id": 18,
	  "name": "第十八关：算力风暴",
	  "cols": 10,
	  "rows": 9,
	  "step_limit": 29,
	  "grid": [
		[1, 1, 1, 1, 1, 1, 1, 1, 1, 1],
		[1, 3, 0, 0, 0, 0, 0, 0, 0, 1],
		[1, 0, 0, 0, 2, 0, 0, 0, 0, 1],
		[1, 0, 0, 0, 0, 0, 0, 0, 0, 1],
		[1, 0, 0, 0, 0, 2, 0, 0, 0, 1],
		[1, 0, 0, 0, 0, 0, 0, 0, 0, 1],
		[1, 0, 0, 0, 0, 0, 0, 2, 0, 1],
		[1, 0, 0, 0, 0, 0, 0, 0, 2, 1],
		[1, 1, 1, 1, 1, 1, 1, 1, 1, 1]
	  ],
	  "targets": [[6, 2], [4, 4], [7, 6], [8, 7]]
	},
	{
	  "id": 19,
	  "name": "第十九关：黎明之前",
	  "cols": 10,
	  "rows": 9,
	  "step_limit": 35,
	  "grid": [
		[1, 1, 1, 1, 1, 1, 1, 1, 1, 1],
		[1, 3, 0, 0, 0, 0, 0, 0, 0, 1],
		[1, 0, 0, 2, 0, 0, 0, 0, 0, 1],
		[1, 0, 0, 0, 0, 0, 0, 0, 0, 1],
		[1, 0, 0, 0, 0, 0, 0, 0, 0, 1],
		[1, 0, 0, 0, 0, 2, 0, 0, 0, 1],
		[1, 0, 0, 0, 0, 0, 0, 0, 0, 1],
		[1, 0, 0, 0, 0, 0, 0, 2, 0, 1],
		[1, 1, 1, 1, 1, 1, 1, 1, 1, 1]
	  ],
	  "targets": [[4, 2], [7, 4], [6, 6], [7, 7]]
	},
	{
	  "id": 20,
	  "name": "第二十关：终局之战",
	  "cols": 10,
	  "rows": 10,
	  "step_limit": 41,
	  "grid": [
		[1, 1, 1, 1, 1, 1, 1, 1, 1, 1],
		[1, 3, 0, 0, 0, 0, 0, 0, 0, 1],
		[1, 0, 0, 0, 2, 0, 0, 0, 0, 1],
		[1, 0, 0, 0, 0, 0, 0, 0, 0, 1],
		[1, 0, 0, 0, 0, 0, 0, 0, 0, 1],
		[1, 0, 0, 0, 0, 2, 0, 0, 0, 1],
		[1, 0, 0, 0, 0, 0, 0, 0, 0, 1],
		[1, 0, 0, 0, 0, 0, 0, 2, 0, 1],
		[1, 0, 0, 0, 0, 0, 0, 0, 2, 1],
		[1, 1, 1, 1, 1, 1, 1, 1, 1, 1]
	  ],
	  "targets": [[3, 2], [6, 4], [7, 7], [8, 8]]
	}
  ]
}
